  _____ _         __      __       _    _    ___           
 |_   _| |_  ___  \ \    / /__ _ _| |__| |  / __|__ _ _ _  
   | | | ' \/ -_)  \ \/\/ / _ \ '_| / _` | | (__/ _` | ' \ 
   |_| |_||_\___|   \_/\_/\___/_| |_\__,_|  \___\__,_|_||_|

Tabbed 11/22/2022
Tuning: DADGBE   

INTRO
|----------------0-----------------------------------------------------------
|----------------2-----------------------------------------------------------
|-4-4-3-0--------4-----------------------------------------------------------
|-0-0-0-0--------4-----------------------------------------------------------
|-5-4-4-2-4-4-5--0-----------------------------------------------------------
|----------------0-----------------------------------------------------------
_______________________________________________________________________________

MAIN CHORD
|-0--------------------------------------------------------------------------
|-2--------------------------------------------------------------------------
|-4--------------------------------------------------------------------------
|-4--------------------------------------------------------------------------
|-0--------------------------------------------------------------------------
|-0--------------------------------------------------------------------------
_______________________________________________________________________________

EMBELLISHMENTS 
|----------------------------------------------------------------------------
|-----------0--------0-------------------------------------------------------
|----0-----------0-----------------------------------------------------------
|-------12---------7---------------------------------------------------------
|--9-----------4-------------------------------------------------------------
|------------------------4/7-------------------------------------------------

|--0--0----0--0----0--0----0--0----------------------------------------------
|--0--0----0--0----0--0----0--0----------------------------------------------
|--0--0----0--0----0--0----0--0----------------------------------------------
|--0--0----0--0----0--0----0--0----------------------------------------------
|--2--2----2--4----4--4----5/-6----------------------------------------------
|--0--0----0--0----0--0----0--0----------------------------------------------

|--0--0----------------------------------------------------------------------
|--2--3----------------------------------------------------------------------
|--0--0----------------------------------------------------------------------
|--2--2----------------------------------------------------------------------
|--0--0----------------------------------------------------------------------
|----------------------------------------------------------------------------
_______________________________________________________________________________

B SECTION 
|----------------------------------------------------------------------------
|--------0-------0-------0-------0-------------------------------------------
|------7-------6-------6-------6---------------------------------------------
|----0-------0-------0-------0-------transition-out-with-last-embellishment--
|--5-------4---------------4-------------------------------------------------
|------------------5---------------------------------------------------------
